피구 = dodge ball
탁구 = table tennis
테니스 = tennis
배구 = volleyball
농구 = basketball
미식축구 = American football
축구 = soccer
야구 = baseball
스포츠 = sports
깨물다 = bite
읽다 = read
생각 = thought
가장 = the most
맛없는 = tasteless
재미없는 = not fun
맛있는 = delicious
있는 = with possession
없는 = without
재미있는 = interesting
언어로 = in a language
강아지 = puppy
쉬운 = easy
어렵지 = difficult
긴 = long
꿀 = honey
달아요 = sweet
신 = sour
매워요 = spicy
써요 = bitter
쓴 = bitter
신선한 = fresh
짭니다 = salty
짧은 = short
뛰어요 = jump
소금 = salt
치맥 = fried chicken and beer
김 = laver
목이 말라요 = thirsty
배고파요 = hungry
고픕니다 = hungry
목 = throat
배 = stomach
치킨 = Fried chicken
아이스크림 = ice cream
과자 = snack or crackers
피자 = pizza
라면 = ramen
초콜릿 = chocolate
식사로 = meal
후추 = pepper
설탕 = sugar
케이크 = cake
샌드위치 = sandwich
파스타 = pasta 
감자 = potato
달걀 = eggs
치즈 = cheese
닭고기 = chicken
돼지고기는 = pork
고기 = meat
계란 = egg
소고기 = beef
생선 = fish
귤을 = tangerine
갑니다 = on my way
바나나 = banana
딸기가 = strawberry
옥수수 = corn
고추가 = chili pepper
기름 = oil
마도없습니다 = not tasty
과일 = fruits
와인 = wine
야채 = vegetables
밥 = rice
맥주 = beer
커피 = coffee
주스 = juice
수프 = soup
토마토 = tomato 
오렌지 = orange
우유 = milk
맛있습니다 = tasty
접시 = plate
아침 = breakfast
식사 = a meal
던지지 = throw
그릇을 = dish
저녁 = dinner
반잔 = side dish
점심 = lunch
그들은 = they
알겠습니다 = affirmative
압니다 = to know
서로 = each other
자기의 = on its own
자신을 = myself
혼자 = alone
그녀가 = she
그는 = he
당신 = you
놀려요 = to make fun of
마십시요 = to tease
속입니다 = deceive
내 = my
이름은 = name
믿으십시오 = believe
너희와 = you and
싫어요 = dislike
사랑해요 = love
미워합니다 = hate
우리 = we
나의 = my
아저씨 = sir
어떤 = what kind
아주머니 = maam
왜 = why
어느 = which
님 = Mr
어떻게 = how
무슨 = which one
언제 = when
옵니까 = arrive
배웁시다 = lets learn
요리합시다 = lets cook
메일 = everyday
맙시다 = lets not do that
남기지 = to leave
정서합니다 = lets clean
등산합시다 = lets climb a mountain
함께 = together
식사합시다 = lets eat
찍읍시다 = lets film
사진 = picture
극장 = theater
합시다 = lets do
박물관 = museum
마십시요 = do not
괜찮아 = fine
걱정하지 = worry
만지지 = do not touch
빨리 = quickly
웃으십시오 = please laugh
보십시오 = please look
덜 = fewer
손님 = sir
조심하십시오 = please be careful
다시 = again
더 = more
배우십시오 = please learn
천천히 = go slowly
집중하십시오 = please focus
추워요 = cold
날씨 = weather
음악 = music
그래요 = like that
그렇지 = is not like that
건강해요 = healthy
비슷하지 = not similar
일해요 = work
저래요 = is like that
비슷해요 = similar
열쇠 = key
이어요 = to connect
길러요 = to raise a child
건물을 = building
지어요 = to build
과 = comparison marker
나아요 = get well
병은 = illness
달라요 = different than
몰라요 = dont know
라디오 = Radio
동물이 = animals
어둡지 = not dark
걸어요 = walk
들어요 = listen
물어요 = ask
어두워요 = dark
더와요 = to help
길에 = street
누워요 = lie down
맞지 = correct
않아요 = is not
사라져요 = disappear
잠가요 = to lock
울지 = not cry
울어요 = cry
내려요 = get out
보아요 = to look
텔레비전 = tv
던집니다 = throw
만큼 = much
편 = side
같이 = together 
이편으로 = this direction
달립니다 = run
침대 = bed
가방 = bag
나무 = tree
여기에 = here
에 = location marker
거기 = there
호텔이 = Hotel
옴니다 = to come
그쪽 = that way
책상 = desk
식당 = restaurant
화장실 = bathroom
죄송합니다 = sorry
싫어합니다 = excuse me
그 = the
그것은 = it is
매력이 = attractive
이 = this
건물 = building
책상 = desk
우의 = friendship
위 = above
지루합니다 = boring
슬픕니다 = sad
영화는 = movie
행복합니다 = happy
기쁩니다 = glad
아픕니다 = sick
피곤합니다 = tired
친절합니다 = kind
가수는 = singer
바쁩니다 = busy
이상합니다 = strange
영리합니다 = clever
똑똑합니다 = smart
게으릅니다 = lazy
작습니다 = short
날씨합니다 = thin
더럽습니다 = dirty
바다가 = sea
예쁩니다 = pretty
뚱뚱합니다 = fat
블루윙즈 = blue wings
귀엽습니다 = cute
큽니다 = tall
키가 = height
드래곤즈 = dragons
공원이 = park
깨끗합니다 = clean
아름답습니다 = beautiful
장소가 = place
한국은 = Korea
빵이 = bread
방이 = room
줍습니다 = cold
덥습니다 = hot
넓습니다 = wide
좁습니다 = small
높습니다 = tall
길이 = road
낮습니다 = low
산 = mountain
뜨거 = hot
음식 = food
무거운 = Heavy
산문 = newspaper
빨리 = fast
자동차 = car
싸다 = cheap
